"filename", "language", "Vue", "JSON", "JavaScript", "HTML", "Markdown", "comment", "blank", "total"
"c:\project\desktop\hy-fitness-data\README.md", "Markdown", 0, 0, 0, 0, 19, 0, 6, 25
"c:\project\desktop\hy-fitness-data\babel.config.js", "JavaScript", 0, 0, 5, 0, 0, 0, 1, 6
"c:\project\desktop\hy-fitness-data\package-lock.json", "JSON", 0, 34108, 0, 0, 0, 0, 1, 34109
"c:\project\desktop\hy-fitness-data\package.json", "JSON", 0, 76, 0, 0, 0, 0, 1, 77
"c:\project\desktop\hy-fitness-data\public\index.html", "HTML", 0, 0, 0, 16, 0, 1, 1, 18
"c:\project\desktop\hy-fitness-data\src\App.vue", "Vue", 176, 0, 0, 0, 0, 4, 6, 186
"c:\project\desktop\hy-fitness-data\src\background.js", "JavaScript", 0, 0, 56, 0, 0, 27, 11, 94
"c:\project\desktop\hy-fitness-data\src\background\ipc.js", "JavaScript", 0, 0, 133, 0, 0, 21, 4, 158
"c:\project\desktop\hy-fitness-data\src\background\modules\combine.js", "JavaScript", 0, 0, 42, 0, 0, 4, 2, 48
"c:\project\desktop\hy-fitness-data\src\background\modules\divideGroup.js", "JavaScript", 0, 0, 177, 0, 0, 26, 9, 212
"c:\project\desktop\hy-fitness-data\src\background\modules\mergeData.js", "JavaScript", 0, 0, 69, 0, 0, 11, 2, 82
"c:\project\desktop\hy-fitness-data\src\components\Caption.vue", "Vue", 15, 0, 0, 0, 0, 1, 3, 19
"c:\project\desktop\hy-fitness-data\src\components\ImportScore.vue", "Vue", 51, 0, 0, 0, 0, 0, 4, 55
"c:\project\desktop\hy-fitness-data\src\components\ImportScoreFiles.vue", "Vue", 152, 0, 0, 0, 0, 8, 10, 170
"c:\project\desktop\hy-fitness-data\src\components\LocalServer.vue", "Vue", 196, 0, 0, 0, 0, 4, 7, 207
"c:\project\desktop\hy-fitness-data\src\components\NavMenu.vue", "Vue", 61, 0, 0, 0, 0, 33, 4, 98
"c:\project\desktop\hy-fitness-data\src\components\TotalTable.vue", "Vue", 88, 0, 0, 0, 0, 0, 8, 96
"c:\project\desktop\hy-fitness-data\src\components\TutorialLocalServer.vue", "Vue", 41, 0, 0, 0, 0, 0, 4, 45
"c:\project\desktop\hy-fitness-data\src\main.js", "JavaScript", 0, 0, 44, 0, 0, 0, 5, 49
"c:\project\desktop\hy-fitness-data\src\preload.js", "JavaScript", 0, 0, 14, 0, 0, 0, 8, 22
"c:\project\desktop\hy-fitness-data\src\router\index.js", "JavaScript", 0, 0, 35, 0, 0, 8, 5, 48
"c:\project\desktop\hy-fitness-data\src\store\index.js", "JavaScript", 0, 0, 38, 0, 0, 2, 4, 44
"c:\project\desktop\hy-fitness-data\src\store\modules\handleExcel.js", "JavaScript", 0, 0, 177, 0, 0, 25, 22, 224
"c:\project\desktop\hy-fitness-data\src\store\modules\localServer.js", "JavaScript", 0, 0, 16, 0, 0, 0, 2, 18
"c:\project\desktop\hy-fitness-data\src\views\Home.vue", "Vue", 15, 0, 0, 0, 0, 0, 3, 18
"c:\project\desktop\hy-fitness-data\src\views\Jjzk.vue", "Vue", 51, 0, 0, 0, 0, 0, 4, 55
"c:\project\desktop\hy-fitness-data\src\views\PadData.vue", "Vue", 27, 0, 0, 0, 0, 0, 4, 31
"c:\project\desktop\hy-fitness-data\src\views\Roster.vue", "Vue", 15, 0, 0, 0, 0, 0, 4, 19
"c:\project\desktop\hy-fitness-data\src\views\ScoreTable.vue", "Vue", 20, 0, 0, 0, 0, 1, 4, 25
"c:\project\desktop\hy-fitness-data\src\views\Tester.vue", "Vue", 15, 0, 0, 0, 0, 0, 4, 19
"c:\project\desktop\hy-fitness-data\vue.config.js", "JavaScript", 0, 0, 7, 0, 0, 3, 1, 11
"Total", "-", 923, 34184, 813, 16, 19, 179, 154, 36288